2 0 0 0 0 0 0 10
0 1 0 0 0 0 0 10
2 1 0 0 0 0 0 10
5 0 0 0 0 0 0 20
0 3 0 0 0 0 0 20
1 0 2 0 0 0 0 20
2 0 1 1 0 0 0 20
0 0 0 0 1 0 0 16
0 3 0 2 0 0 0 30
0 0 3 3 0 0 0 40
5 5 5 0 0 0 0 40
0 0 0 0 0 2 0 40
5 4 3 2 1 1 0 50
0 0 0 0 0 0 1 30
0 0 0 0 5 0 0 20
0 0 0 0 0 3 0 50
9 9 9 9 0 0 0 50
0 0 0 0 5 0 2 50
0 0 0 0 0 5 0 40
9 0 0 0 0 0 4 60
3 3 3 3 3 3 3 40
3 3 3 3 3 3 3 35
3 3 3 3 3 3 3 30
3 3 3 3 3 3 3 25
3 3 3 3 3 3 3 20